1111111111111111111111111111111111
1E000000C000C00C0000XC0X0C000CC001
101001010010C0X0101001000CCC01X101
1010X100101010100010010000X00101X1
1P00000X0C00C00XC00CCC00C0000C00C1
1111111111111111111111111111111111