1111111
1P0C001
1111011
100E001
1011011
1CXC001
1111111