1111111111
1P0000C001
1110111011
10XE100001
1011111011
1000000001
1011111111
1C000XC001
1000X00001
1111111111