111111111111
100011111101
1C0000000001
110001111001
100E10000001
101111111001
10000XC00001
11100000P001
100000000001
1C0001111001
100000CXC001
111111111111