111111111
1P00C0001
111101101
100E100C1
1C0X00X01
111111111