11111111
1P0000E1
111101X1
10000001
1C111101
1000X001
10111111
11111111