111111
1P0001
1C1111
100001
111101
100E01
100001
111101
1C0001
111111