11111111111
1P00000C001
11111111101
10000E00001
10111111101
100C0000001
10111111101
10000000001
11111111101
1C000000001
11111111111